░░░░░░░░░░░░░░░░░░░░░░░░░░░░░░░░░░░░░░░░░░░░░░░░░░░░░░░░░░░░░░░░░░░░░░░░░░░░░░░░░░
░░██████████████░░██████████████████████████░░██████░░██████████████████░░██████░░
░░░░░░██░░░░░░░░░░██░░░░░░░░░░██░░░░░░░░░░██░░██░░░░░░██░░██░░░░░░░░░░██░░██░░██░░
░░██████░░██████████████████░░██░░██████░░██░░██████████░░██████████░░██░░██░░██░░
░░██░░░░░░██░░░░░░░░░░░░░░░░░░██░░██░░██░░██░░░░░░░░░░░░░░░░░░░░░░██░░██░░░░░░██░░
░░██████░░██████████░░██████░░██░░██░░██░░██░░██████████████████████░░██████░░██░░
░░██░░██░░██░░░░░░░░░░██░░██░░██░░██░░██░░██░░██░░░░░░██░░░░░░░░░░░░░░░░░░██░░██░░
░░██░░██████░░██████████░░██████░░██░░██░░██████░░██████░░██████░░██████████████░░
░░██░░░░░░░░░░██░░██░░░░░░░░░░░░░░██░░██░░░░░░░░░░██░░░░░░██░░██░░░░░░░░░░░░░░░░░░
░░██░░██████████░░██░░██████████████░░██░░██████████░░██████░░██████████████████░░
░░██░░██░░░░░░░░░░░░░░██░░░░░░░░░░░░░░██░░░░░░░░░░░░░░██░░░░░░░░░░░░░░░░░░░░░░██░░
░░██░░██████░░██████████░░██████████████░░██████░░██████░░██░░██████████████░░██░░
░░░░░░░░░░██░░██░░░░░░░░░░██░░██░░░░░░░░░░██░░██░░██░░░░░░██░░██░░░░░░░░░░██░░██░░
░░██████░░██████████████░░██░░██░░██████████░░██░░██████████░░██░░██████░░██████░░
░░██░░██░░░░░░░░░░░░░░░░░░██░░██░░██░░░░░░░░░░██░░░░░░██░░░░░░██░░░░░░██░░░░░░░░░░
░░██░░██████████░░██████████░░██░░██████░░██░░██████████░░██████░░██████░░██████░░
░░██░░░░░░░░░░██░░██░░░░░░░░░░██░░░░░░██░░██░░░░░░░░░░░░░░██░░░░░░██░░██░░░░░░██░░
░░██░░██████░░██████░░██████░░██░░██░░██████░░██████████░░██░░██████░░██████░░██░░
░░██░░░░░░██░░██░░░░░░░░░░██░░██░░██░░██░░░░░░██░░░░░░██░░██░░██░░░░░░░░░░██░░██░░
░░██████░░██████░░██████░░██████████░░██░░S ░░██░░██░░██████░░██████░░██████░░██░░
░░██░░██░░░░░░░░░░██░░██░░██░░░░░░░░░░██░░██░░██░░██░░░░░░░░░░██░░██░░██░░░░░░██░░
░░██░░██░░██████████░░██░░██████░░██████░░██████░░██████░░██████░░██░░██████████░░
░░██░░██░░██░░░░░░░░░░██░░░░░░░░░░██░░░░░░░░░░░░░░██░░██░░██░░░░░░██░░░░░░░░░░██░░
░░██░░██░░██░░██████░░██░░██████████░░██████████████░░██░░██░░██░░██████████░░██░░
░░░░░░██░░██░░░░░░██░░██░░██░░░░░░░░░░██░░░░░░░░░░██░░░░░░██░░██░░░░░░░░░░██░░██░░
░░██████░░██░░██████░░██░░██████████░░██░░██████░░██████░░██░░██████████░░██░░██░░
░░██░░░░░░██░░██░░░░░░██░░░░░░░░░░██░░██░░██░░░░░░░░░░██░░██░░██░░░░░░░░░░██░░██░░
░░██░░██████░░██░░██████░░██████░░██░░██████░░██████████░░██░░██░░██████░░██░░██░░
░░██░░██░░░░░░██░░██░░██░░░░░░██░░██░░░░░░░░░░██░░░░░░░░░░██░░██░░██░░██░░██░░██░░
░░██████████████░░██░░██████████░░██████████░░██████████████████░░██░░██████░░██░░
░░░░░░░░░░░░░░██░░██░░██░░░░░░░░░░░░░░░░░░██░░░░░░░░░░░░░░░░░░░░░░██░░░░░░░░░░██░░
░░██████░░██████░░██░░██░░██████████████░░██░░██████████████████░░██░░O ████████░░
░░██░░██░░░░░░░░░░██░░░░░░██░░░░░░██░░░░░░██░░██░░░░░░░░░░░░░░██░░██░░░░░░░░░░██░░
░░██░░██████████████░░██████░░██░░██████░░██░░██░░██████████░░██████░░██████░░██░░
░░██░░░░░░░░░░░░░░░░░░██░░░░░░██░░░░░░██░░██░░██░░██░░░░░░██░░░░░░░░░░██░░██░░░░░░
░░██████████████████████░░██████████░░██████░░██████████░░██████████████░░██████░░
░░██░░░░░░░░░░░░░░░░░░░░░░░░░░██░░██░░░░░░░░░░░░░░██░░░░░░░░░░░░░░░░░░░░░░░░░░██░░
░░██░░██████░░██████████████████░░██░░██████████░░██░░██████████████░░██████████░░
░░██░░██░░██░░██░░░░░░░░░░░░░░░░░░██░░░░░░██░░██░░░░░░██░░░░░░░░░░██░░██░░░░░░██░░
░░██████░░██████░░██████████████████████████░░██████████░░██████████████░░██████░░
░░░░░░░░░░░░░░░░░░░░░░░░░░░░░░░░░░░░░░░░░░░░░░░░░░░░░░░░░░░░░░░░░░░░░░░░░░░░░░░░░░

