░░░░░░░░░░░░░░░░░░░░░░░░░░░░░░░░░░░░░░░░░░░░░░░░░░░░░░░░░░░░░░░░░░░░░░░░░░░░░░░░░░
░░      ░░      ░░                          ░░          ░░              ░░      ░░
░░  ░░  ░░  ░░  ░░░░░░░░░░░░░░░░░░  ░░░░░░  ░░  ░░░░░░  ░░░░░░░░░░  ░░  ░░░░░░  ░░
░░  ░░      ░░                  ░░  ░░          ░░  ░░              ░░          ░░
░░  ░░░░░░░░░░░░░░░░░░░░░░░░░░  ░░  ░░░░░░░░░░░░░░  ░░░░░░░░░░░░░░░░░░░░░░░░░░  ░░
░░                      ░░          ░░      ░░          ░░              ░░      ░░
░░  ░░░░░░░░░░░░░░░░░░  ░░░░░░  ░░░░░░  ░░  ░░  ░░  ░░░░░░  ░░░░░░░░░░  ░░  ░░░░░░
░░  ░░              ░░      ░░  ░░      ░░  ░░  ░░          ░░      ░░      ░░  ░░
░░  ░░  ░░░░░░░░░░  ░░░░░░  ░░░░░░  ░░░░░░  ░░  ░░░░░░░░░░░░░░  ░░  ░░░░░░░░░░  ░░
░░      ░░      ░░  ░░  ░░              ░░  ░░                  ░░  ░░O         ░░
░░░░░░░░░░░░░░  ░░  ░░  ░░░░░░░░░░░░░░░░░░  ░░░░░░░░░░░░░░░░░░░░░░  ░░░░░░░░░░  ░░
░░              ░░  ░░          ░░          ░░                  ░░  ░░      ░░  ░░
░░  ░░  ░░░░░░  ░░  ░░  ░░░░░░  ░░  ░░░░░░░░░░  ░░░░░░░░░░  ░░  ░░  ░░  ░░  ░░  ░░
░░  ░░      ░░  ░░      ░░      ░░  ░░      ░░          ░░  ░░  ░░      ░░  ░░  ░░
░░  ░░░░░░  ░░  ░░░░░░  ░░░░░░░░░░  ░░  ░░  ░░░░░░░░░░  ░░  ░░  ░░░░░░░░░░  ░░  ░░
░░      ░░  ░░      ░░  ░░          ░░  ░░      ░░      ░░  ░░          ░░  ░░  ░░
░░░░░░  ░░  ░░░░░░  ░░  ░░  ░░░░░░░░░░  ░░░░░░░░░░  ░░░░░░  ░░  ░░░░░░░░░░  ░░  ░░
░░  ░░  ░░  ░░      ░░  ░░          ░░              ░░  ░░  ░░  ░░          ░░  ░░
░░  ░░  ░░  ░░░░░░░░░░  ░░░░░░░░░░  ░░░░░░░░░░░░░░  ░░  ░░  ░░░░░░  ░░░░░░░░░░  ░░
░░  ░░  ░░          ░░  ░░      ░░      ░░      ░░      ░░      ░░  ░░          ░░
░░  ░░  ░░░░░░░░░░  ░░  ░░  ░░░░░░░░░░  ░░  ░░  ░░  ░░░░░░░░░░  ░░  ░░  ░░░░░░  ░░
░░      ░░      ░░      ░░          ░░  ░░S ░░  ░░  ░░      ░░      ░░      ░░  ░░
░░  ░░░░░░  ░░  ░░░░░░░░░░  ░░  ░░  ░░  ░░░░░░  ░░░░░░  ░░  ░░  ░░░░░░░░░░  ░░  ░░
░░  ░░      ░░      ░░      ░░  ░░  ░░      ░░          ░░  ░░      ░░      ░░  ░░
░░  ░░░░░░░░░░  ░░  ░░░░░░░░░░  ░░░░░░  ░░  ░░░░░░░░░░░░░░  ░░░░░░  ░░  ░░░░░░  ░░
░░  ░░          ░░          ░░  ░░      ░░  ░░          ░░      ░░      ░░      ░░
░░  ░░  ░░░░░░░░░░░░░░░░░░  ░░  ░░  ░░░░░░░░░░  ░░░░░░  ░░░░░░  ░░░░░░  ░░░░░░░░░░
░░      ░░              ░░  ░░  ░░          ░░  ░░          ░░  ░░      ░░      ░░
░░░░░░░░░░  ░░  ░░░░░░░░░░  ░░  ░░░░░░░░░░  ░░  ░░  ░░░░░░  ░░  ░░░░░░░░░░  ░░  ░░
░░  ░░      ░░          ░░              ░░      ░░      ░░  ░░              ░░  ░░
░░  ░░  ░░░░░░░░░░░░░░  ░░░░░░░░░░░░░░  ░░░░░░░░░░░░░░  ░░░░░░░░░░░░░░░░░░░░░░  ░░
░░  ░░          ░░  ░░              ░░  ░░          ░░      ░░                  ░░
░░  ░░░░░░░░░░  ░░  ░░░░░░░░░░░░░░  ░░  ░░░░░░░░░░  ░░░░░░  ░░  ░░░░░░░░░░░░░░░░░░
░░  ░░      ░░          ░░      ░░  ░░  ░░      ░░      ░░      ░░              ░░
░░  ░░  ░░  ░░░░░░░░░░  ░░  ░░  ░░  ░░  ░░  ░░  ░░░░░░  ░░░░░░░░░░░░░░░░░░  ░░  ░░
░░      ░░          ░░      ░░  ░░  ░░  ░░  ░░                      ░░      ░░  ░░
░░  ░░░░░░  ░░░░░░░░░░░░░░░░░░  ░░  ░░  ░░  ░░░░░░░░░░░░░░░░░░░░░░  ░░  ░░░░░░  ░░
░░      ░░                  ░░  ░░      ░░  ░░          ░░          ░░  ░░  ░░  ░░
░░░░░░  ░░░░░░░░░░  ░░░░░░░░░░  ░░░░░░░░░░  ░░  ░░░░░░  ░░  ░░░░░░░░░░  ░░  ░░  ░░
░░              ░░                          ░░      ░░                  ░░      ░░
░░░░░░░░░░░░░░░░░░░░░░░░░░░░░░░░░░░░░░░░░░░░░░░░░░░░░░░░░░░░░░░░░░░░░░░░░░░░░░░░░░

